33333333233333333
33333333233333333
33010000000100033
33020212020202133
33000000001000033
33020202020202033
22001001000010033
33020202020202022
33000000100100133
33120212020202033
33000000000010033
33021202020202033
33000001000100033
33333333233333333
33333333233333333